11111111111
10P01E0C001
11100000111
11111111111