1111111111
1C00001111
1110110011
100000E001
1001000001
1100100001
1100000001
1110000111
11100000P1
1111111111
1000000011
1111111111