111111
1001
111111111
111111
1001
11111111